....,,,,,,,,,.....
,,,,,,,,,,,,,,,,..
,,,,,,,,,,#,,,,,,.
.,,,,,,,,,,,,,,,,,
,,,,,,####,,,,,,,,
.,,,,,,,,##,,,,,,,
.,,,,,,,,#,,,,,,,,
..,,,,,,,,,,,,,...
.....,,..,,,,,....